11111111111111111111111
10000000000000000000001
100000C0000000000000001
10000000000000000000001
100C0P00000000000000001
10000000000000000000001
10000000000000000000001
10000000000000000E00001
10000000C00000000000001
10000000000000000000001
11111111111111111111111