1111111111111
100000C0000C1
1011011111001
10P011000E001
1111111111111