1111111111111
100000C0000C1
1000000000001
1P000000000E1
1111111111111
