11111111111111111111111
1000000000000001C010001
100000C0000000011010001
10000000000000010000001
100C0P00000000011100001
10000000000000000E00001
10000000000000000000001
10000000000000000000001
100C0000C00000000000001
10000000000000000000001
11111111111111111111111