11111111
1000C001
10001111
1C000EP1
11111111