11111111
10P0C001
10001111
1C000E01
11111111