11111111
1E00C001
10001111
1C0000P1
11111111