11111111
1000C001
1E001111
1C0000P1
11111111