11011
1PCC1
1C0E1
10001
10001
11111