11111111
1P00C001
10000001
1C000E01
11111111