1111111111
1C00E00001
1000000001
1000001111
1C000010P1
1111111111