1111111111
1C10000001
1010000001
1010000001
1C1000E0P1
1111111111