1111111111
1C00000001
1000000001
1000001111
1C0000E0P1
1111111111